ABC = "countries/Nomads.txt"

AVI = "countries/Avvnie.txt"
GRT = "countries/Gartiva.txt"
BRK = "countries/Barkenia.txt"
CUM = "countries/Cussemini.txt"
LAN = "countries/Lantrio.txt"
BOR = "countries/BSOFS.txt"

YXN = "countries/Yxginn.txt"
CAT = "countries/Castaria.tct"
ESK = "countries/Estalakerden.txt"
SDV = "countries/Sudvinnen.txt"

BTN = "countries/Bretagne.txt"
AQT = "countries/Aquatuanie.txt"
OCT = "countries/Occatanje.txt"
ANL = "countries/Arañellos.txt"
RUM = "countries/RepUnidMontañas.txt"
GAJ = "countries/Gajaritas.txt"
PAR = "countries/Parlouwello.txt"
WGT = "countries/WGTotalitarians.txt"
USF = "countries/UnionSF.txt"
GAR = "countries/Garanatai.txt"

WAL = "countries/Waelia.txt"
COR = "countries/Corrivié.txt"
FRA = "countries/Farracasicia.txt"
NER = "countries/Neriffiticia.txt"
SOC = "countries/Soccotorro.txt"
NAR = "countries/Narrvii.txt"
DUB = "countries/Dubliniv.txt"
CER = "countries/Cerck.txt"
NMD = "countries/Normandié.txt"
LIC = "countries/LCOIP.txt"
NDL = "countries/Nederland.txt"