## GENERATED

LMB = "countries/Lammbouir.txt"
RUI = "countries/Ruinaires.txt"
CTL = "countries/Costilliere.txt"
PIR = "countries/Piratecove.txt"
UMB = "countries/Unitedmercenaries.txt"
SGM = "countries/ï¿½sigvmutan.txt"
NLQ = "countries/Norlorqs.txt"
UDL = "countries/Uldriklands.txt"
SUI = "countries/Sarroui.txt"
ITZ = "countries/Itzerla.txt"
IQI = "countries/Isletueteriqui.txt"
NQV = "countries/Norriquiva.txt"
SQV = "countries/Surriquiva.txt"
UTV = "countries/Unitrevita.txt"
FSH = "countries/F'ish.txt"
FAL = "countries/Falandia.txt"
SVL = "countries/Sarvundland.txt"
TTR = "countries/TallRepublic.txt"
GTL = "countries/Gaestertland.txt"
GCT = "countries/Gunther Cult.txt"
LSA = "countries/Linguisatia.txt"
VTR = "countries/Vasterreich.txt"
JHT = "countries/Jaggdhunt.txt"
SSE = "countries/SchiffesEinlass.txt"
AGT = "countries/Aggatten.txt"
KGI = "countries/Kolgi.txt"
AEN = "countries/Anetian.txt"
IKN = "countries/Intkarnen.txt"
SMT = "countries/Skogsmakten.txt"
GTL = "countries/Gotaland.txt"
OLL = "countries/Olofsland.txt"
SSN = "countries/Sashanation.txt"
SKT = "countries/Storkusten.txt"
GAT = "countries/Grunnnarten.txt"
DNS = "countries/Disunited Northern Strongholds.txt"
FBS = "countries/Fjellbyestaten.txt"
SKR = "countries/Storkratern.txt"
DVN = "countries/DjurVannerna.txt"
GTK = "countries/Gustafskust.txt"
GNK = "countries/Grenakusten.txt"
DVM = "countries/DavidssonsMark.txt"
VMK = "countries/Visbys Militar kommando.txt"
KKT = "countries/Karls Kungatron.txt"
MKN = "countries/MellanKlammern.txt"
SJB = "countries/StorJohansBy.txt"
ERS = "countries/EriksStad.txt"
SSS = "countries/Stor Staten Sofie.txt"
SBG = "countries/Storbergen.txt"
KLG = "countries/Kartlannegutt .txt"
SST = "countries/Sidstaratinan.txt"
KLV = "countries/Kvareleveran.txt"
KTN = "countries/Kanten.txt"
CLA = "countries/Courlia.txt"
ACE = "countries/Acriczte.txt"
CMA = "countries/Crezmia.txt"
UKH = "countries/Utssig Khaganate.txt"
TZA = "countries/Tzerlia.txt"
LIU = "countries/Liuquarden.txt"
KGE = "countries/Karguele.txt"
KLA = "countries/Karlenia.txt"
LUA = "countries/Luthria.txt"
MIN = "countries/Minska.txt"
KAA = "countries/Karlia.txt"
MEN = "countries/Mergan.txt"
VYE = "countries/Vyrrian Empire.txt"
NVT = "countries/NavalTribes.txt"
FGC = "countries/Federation of Greek Cities.txt"
AII = "countries/Akiri.txt"
VNA = "countries/Vanetia.txt"
CEI = "countries/Celinia.txt"
GCY = "countries/Golden City.txt"
MAL = "countries/Maltia.txt"
ILI = "countries/Islas Lisabona.txt"
KKA = "countries/Kalvi Khanate.txt"
CUU = "countries/Cuulia.txt"
FIN = "countries/Finlandia.txt"
RIG = "countries/Rigua.txt"
CEE = "countries/Castyrian Empire.txt"
ZDS = "countries/Zaladoslavie.txt"
RDS = "countries/Regencia del sud.txt"
GAL = "countries/Galicia.txt"
ISL = "countries/Ísland.txt"
NGD = "countries/Novgorod.txt"
LIN = "countries/Litgarten.txt"
AUU = "countries/Auvurgen.txt"
ILL = "countries/Illria.txt"
MOS = "countries/Moskva.txt"
OST = "countries/Ostarruthian Empire.txt"